R  960	960
NO ./texture/wall/wall_korean_n.xpm
SO ./texture/wall/wall_korean_s.xpm
WE ./texture/wall/wall_korean_w.xpm
EA ./texture/wall/wall_korean_e.xpm

S ./texture/fun/cake.xpm

F 112,112,112
C 56,56,56

111111111111111111111111111111
100000000000001100000000000001
1000000000000011000000000S0001
100000000000001100000000000001
100020000000000000000000000001
100000S00000000000000002000001
100000000000000000000000000001
10000N00000000W000000000000001
100000000000000000000000000001
100002000000000000000200000001
100000000000000000000000000001
100000000000000200000000000001
111111111111111111111111111111