R  960	960
NO ./texture/wall/wall_korean_n.xpm
SO ./texture/wall/wall_korean_s.xpm
WE ./texture/wall/wall_korean_w.xpm
EA ./texture/wall/wall_korean_e.xpm

S ./texture/fun/cake.xpm

F 112,112,112
C 56,56,56

111111111111111111111111111111
111111111110000000011111111111
111111111000000000000111111111
111111100020000002000000011111
111110000000000000000000001111
111000000000000000000200000011
110000000000000000000000000001
11100000000000W000000000000011
111110000000000000000200001111
111111100000002000000000111111
111111111000000000000011111111
111111111110000000001111111111
111111111111111111111111111111