R  960	960
NO ./texture/wall/wall_korean_n.xpm
SO ./texture/wall/wall_korean_s.xpm
WE ./texture/wall/wall_korean_w.xpm
EA ./texture/wall/wall_korean_e.xpm

S ./texture/fun/cake.xpm

F 112,112,112
C 56,56,56

111111111111111111111111111111
100000000000000000000000000001
100111111111111111111111111111
100000000000000000000000000001
111111111111111111111111111001
100000000000200000000000000001
100111111111111111111111111111
100000200000000W00000000000001
111111111111111111111111111001
100002000000000000000200000001
100111111111111111111111111111
100000000000000200000000000001
111111111111111111111111111111