R  1024		1024
NO ./texture/annabella/annabella_00.xpm
SO ./texture/annabella/annabella_01.xpm
WE ./texture/annabella/annabella_02.xpm
EA ./texture/annabella/annabella_03.xpm

S ./texture/annabella/annabella_04.xpm

F 112,112,112
C 56,56,56

111111111111111111111111111111
100000000000000000000000000001
1002000000111111111111000000011111111111111111111111111111111111111111111111111111
1000000000200000000000000000000000000000000000000000000000000000000000000000000001
1000100000000000000011111000010000000002222000000000022000000000000222222220000001
1000100020000000000000000000010000000022002200000000022000000000002200000222000001
1000000000000000000000000000000000000220000220000000022000000000022000000022200001
100001000000000W000010000000010000002200000022000000022000000000022000000000000001
1000011000000000000010000000010000022022222222200000022000000000022000022222200001
1000011100000000000010000000010000222222222220220000022000000000022000000022200001
1000000000010110000000000000010002200000000000022000022000000000002200000022000001
1002000000000000000000000000010022000000000000002200022222222220000222222222000001
1111111111111111111111111111110000000000000000000000000000000000000000000000000001
1111111111111111111111111111111111111111111111111111111111111111111111111111111111